start - âœ…Inicia el bot
ayuda - ğŸ“¨Ayuda sobre el bot
comandos - ğŸ“‹Muestra los comandos del bot
userinfo - ğŸ¤–Ver si eres admin o usuario del bot
info - âš™ï¸ConfiguraciÃ³n actual
token - ğŸ”Ver token de la cuenta
admin - ğŸ‘‘AÃ±adir admin
add - ğŸ‘¤AÃ±adir usuario
prueba - â±AÃ±adir usuario en modo prueba
ban - ğŸšªBanear usuario
acc - ğŸ“‘Credenciales (usuario,contraseÃ±a)
host - â˜ï¸Url de la nube
zips - ğŸ“šTamaÃ±o de zips
repo - ğŸ†”Repo ID
del_all - ğŸ—‘Eliminar todos los archivos
nube - â˜ï¸Tipo de nube (moodle o cloud)
dir - ğŸ“Carpeta destino de la cloud
up - ğŸ“¤Tipo de subida a moodles (evidence, draft, blog, calendar)
files - ğŸ“¦Archivos de la nube
tuguer087 - ğŸ“‹Obtener base de datos
proxy - ğŸ§¬Equipar proxy
off_proxy - ğŸš«Desequipar proxy
cript - ğŸ”ŒEncriptar proxy
decript - ğŸ”ŒDesencriptar proxy
view_proxy - ğŸ§¬Ver proxy actual
encrypt_on - ğŸ”®Encriptar enlaces de descarga
encrypt_off - ğŸ”®No Encriptar enlaces de descarga
acerca - â„¹ï¸InformaciÃ³n sobre el bot
posgrado - ğŸŒ©Config Posgrado (15Mb)
aulacened - ğŸŒ©Config Aulacened (120Mb)
uclv - ğŸŒ©Config Uclv (200Mb)
eva - ğŸŒ©Config Eva (99Mb)
cursos - ğŸŒ©Config Cursos (99Mb)
eduvirtual - ğŸŒ©Config Edu (1.9GB)
ismm - ğŸŒ©Config Ismm (50Mb)
uvs - ğŸŒ©Config Uvs (25Mb)
aula_uclv - ğŸŒ©Config AulaUclv (60Mb)